"id";"country";"artist";"song";"countryId";"runningOrder";"placed";"placedJury";"placedTelevote";"placedDiff";"totalPoints";"pointsJury";"pointsTelevote";"pointsDiff";"youtubeLink";"appleMusicLink";"spotifyLink"
1;"Bosnia and Herzegovina";"Nino";"Hano";26;3;14;12;12;0;29;6;23;17;"https://youtu.be/7_D7uZ92Y00?si=IUdLvPtaksc0tN1R";"https://music.apple.com/gb/album/hano/260009845?i=260011301";NULL
2;"Croatia";"Vanna";"Strings of My Heart";27;10;10;3;15;12;42;26;16;10;"https://youtu.be/i4BSbWNOp2Q?si=UF78ebAUtF7hTv9D";"https://music.apple.com/gb/album/strings-of-my-heart/381360621?i=381361647";"https://open.spotify.com/track/7b011YotePNLplTMrbMgnu?si=26efadd4bb1045df"
3;"Denmark";"Rollo and King";"Never Ever Let You Go";9;23;2;7;2;5;177;16;161;145;"https://youtu.be/sig2Pv-gb9g?si=LRUrT04wfgxIwJQd";"https://music.apple.com/gb/album/never-ever-let-you-go/1250452265?i=1250452787";"https://open.spotify.com/track/7mx6IZujrnfHLBmqcIOxIe?si=86ba587c4bb44fe1"
4;"Estonia";"Tanel Padar, Dave Benton and 2XL";"Everybody";29;20;1;1;1;0;198;35;163;128;"https://youtu.be/IEQa8Q9x5Ag?si=ejAef6bONbstogbx";NULL;NULL
5;"France";"Natasha St-Pier";"Je n'ai que mon âme";2;14;4;2;4;2;142;30;112;82;"https://youtu.be/L0OipASctkY?si=a59aN4JigdsL_Or1";"https://music.apple.com/gb/album/je-nai-que-mon-%C3%A2me/207129085?i=207129185";"https://open.spotify.com/track/10p0nLnAzyyVr4YWxaSerl?si=7f5010e76a39473b"
6;"Germany";"Michelle";"Wer Liebe lebt";3;19;8;8;8;0;66;15;51;36;"https://youtu.be/8BYoMsX-nAs?si=aefS6_zgIywrkDXW";"https://music.apple.com/gb/album/wer-liebe-lebt-grand-prix-version/724858088?i=724858517";"https://open.spotify.com/track/5IM7R4kdvVPUQ2bDhm9Yvp?si=d05f7d4152854d8d"
7;"Greece";"Antique";"Die for You";21;22;3;4;3;1;147;24;123;99;"https://youtu.be/H9z-Im59asU?si=f_gtoqtByzUspBxg";"https://music.apple.com/gb/album/i-would-die-for-you/375834795?i=375834808";"https://open.spotify.com/track/2byZAXWOqDx3w8suK3btui?si=cfd96c41561f4184"
8;"Iceland";"Two Tricky";"Angel";25;2;21;15;19;4;3;0;3;3;"https://youtu.be/efZ86C_ufvw?si=Z1OT95H8DuiZQVXc";"https://music.apple.com/gb/album/angel-eurovision-edit/1631757940?i=1631757942";"https://open.spotify.com/track/7nenj7SolCHKV3s8mjAHf8?si=beeb9b4f6a404e5e"
9;"Ireland";"Gary O'Shaughnessy";"Without Your Love";18;12;20;15;18;3;6;0;6;6;"https://youtu.be/1SLEkOX9ZLY?si=HRxIivJ8xjXB1fMp";NULL;NULL
10;"Israel";"Tal Sondak";"Ein Davar";20;5;16;9;17;8;25;14;11;3;"https://youtu.be/IA7d3pBUoHU?si=F8ZrZzlZj0MEXfUV";NULL;NULL
11;"Latvia";"Arnis Mednis";"Too Much";37;9;18;15;15;0;16;0;16;16;"https://youtu.be/uN0WwwEL81I?si=djW_VOuA158EKu4j";"https://music.apple.com/gb/album/too-much-eurovision-mix/903636767?i=903636846";"https://open.spotify.com/track/3XJ8YC4wks6m14Jy2p6QNQ?si=fe1998bb85b942f2"
12;"Lithuania";"Skamp";"You Got Style";31;8;13;10;12;2;35;12;23;11;"https://youtu.be/r8LV0h7ixCY?si=s_HU2ybNk8ifTvHj";"https://music.apple.com/gb/album/you-got-style/268403218?i=268403710";"https://open.spotify.com/track/02AK9DE6ttEbcFxMOim4YZ?si=01d1dc38389b48ef"
13;"Malta";"Fabrizio Faniello";"Another Summer Night";19;21;9;10;9;1;48;12;36;24;"https://youtu.be/_cYITo2AH0A?si=RbgAWnqbCr76JKD7";"https://music.apple.com/gb/album/another-summer-night/1572199723?i=1572199726";"https://open.spotify.com/track/2TumtigUX7Z0RCiBlFT8YL?si=8e2edbd312af4ff4"
14;"Netherlands";"Michelle";"Out on My Own";6;1;18;14;16;2;16;1;15;14;"https://youtu.be/5h2Kbu-aPu0?si=zEb_-ZnZOBJ-QQgv";NULL;NULL
15;"Norway";"Haldor Lægreid";"On My Own";13;4;21;15;19;4;3;0;3;3;"https://youtu.be/t7onuhcUkDw?si=yQERtKkHOt70saRS";"https://music.apple.com/gb/album/on-my-own/968913879?i=968913887";"https://open.spotify.com/track/3d1jFD6GZdBev8CVsuHZkU?si=254887fc3ce74304"
16;"Poland";"Piasek";"2 Long";32;18;19;15;17;2;11;0;11;11;"https://youtu.be/ZRp_8JXsWmU?si=3ZVvdwS51cGZlWTN";NULL;NULL
17;"Portugal";"MTM";"Só sei ser feliz assim";17;11;17;15;14;1;18;0;18;18;"https://youtu.be/xbwONk0d_o8?si=VpVXtj6YUMI6gbgn";"https://music.apple.com/gb/album/s%C3%B3-sei-ser-feliz-assim/194891634?i=194891648";"https://open.spotify.com/track/7yfglLcSabGHzfcpB580q0?si=1ab770f7e8ff48d5"
18;"Russia";"Mumiy Troll";"Lady Alpine Blue";34;6;12;13;10;3;37;4;33;29;"https://youtu.be/cI33ZG-vL1I?si=6yxpxw6QMGAKYUWb";NULL;NULL
19;"Slovenia";"Nuša Derenda";"Energy";28;17;7;6;7;1;70;18;52;34;"https://youtu.be/yzXmzCMOLQY?si=H1U4lAlUcGMtEtqA";NULL;NULL
20;"Spain";"David Civera";"Dile que la quiero";15;13;6;8;6;2;76;15;61;46;"https://youtu.be/A5m6oQTwrNc?si=_1xFnYlWw0cMTFJj";"https://music.apple.com/gb/album/dile-que-la-quiero/1171270372?i=1171270386";"https://open.spotify.com/track/0so2Jlze25HJtPYZnEUMzr?si=87ac976c76ed4d73"
21;"Sweden";"Friends";"Listen to Your Heartbeat";11;7;5;5;5;0;100;19;81;62;"https://youtu.be/xR4BFQYFzMU?si=o8h8A1lk9cj8eQQl";"https://music.apple.com/gb/album/listen-of-your-heartbeat/276487022?i=276487185";"https://open.spotify.com/track/4tLsZwIvw2kAzJm58ozxJP?si=4846ac278da54789"
22;"Turkey";"Sedat Yüce";"Sevgiliye Son";22;15;11;11;11;0;41;11;30;19;"https://youtu.be/PxjtZLYX7Us?si=xkWeYs_Rb6oyztUo";NULL;NULL
23;"United Kingdom";"Lindsay Dracass";"No Dream Impossible";10;16;15;12;13;1;28;6;22;16;"https://youtu.be/qxrp0XzzpzY?si=7WVuTEYViPvqpS1Q";"https://music.apple.com/gb/album/no-dream-impossible/1506899964?i=1506900399";"https://open.spotify.com/track/4C1e3sDWIeJQCLN7bVWV9Q?si=a5c4df009fdc4373"
